####################
#B                 #
#      #####       #
#  B     #         #
#        #         #
#        #         #
#                  #
#                  #
#        #         #
#    #####     #   #
#              #   #
#              #   #
#     ####     #   #
#              #   #
#        #     #   #
#        #         #
#        #         #
#      #####    ]B #
#                  #
####################